180 55
6 6 6 6 6 6 6 6 6 6 6 6 6 6 6 6 6 6 6 6 6 6 6 6 6 6 6 6 6 6 6 6 6 6 6 6 6 6 6 6 6 6 6 6 6 6 6 6 6 6 6 6 6 6 6
6 6 6 6 6 6 6 6 6 6 6 6 6 6 6 6 6 6 6 6 6 6 6 6 6 6 6 6 6 6 6 6 6 6 6 6 6 6 6 6 6 6 6 6 6 6 6 6 6 6 6 6 6 6 6
6 6 6 6 6 6 6 6 6 6 37 6 6 6 6 6 6 6 6 6 6 6 6 6 6 6 6 6 6 6 6 6 6 6 6 6 6 6 6 6 6 6 6 6 6 6 6 6 6 6 6 6 6 6 6
6 6 6 6 6 6 6 6 6 37 37 6 6 6 6 6 6 6 6 6 6 6 6 6 6 6 6 6 6 6 6 6 6 6 6 6 6 6 6 6 6 6 6 6 6 6 6 6 6 6 6 6 6 6 6
6 6 6 6 6 6 6 6 6 37 37 37 6 6 6 6 6 6 6 6 6 6 6 6 6 6 6 6 6 6 6 6 6 6 6 6 6 6 6 6 6 6 6 6 6 6 6 6 6 6 6 6 6 6 6
6 6 6 6 6 6 6 6 37 37 37 37 6 6 6 6 6 6 6 6 6 6 6 6 6 6 6 6 6 6 6 6 6 6 6 6 6 6 6 6 6 6 6 6 6 6 6 6 6 6 6 6 6 6 6
6 6 6 6 6 6 6 6 37 37 37 37 37 6 6 6 6 6 6 6 6 6 6 6 6 6 6 6 6 6 6 6 6 6 6 6 6 6 6 6 6 6 6 6 6 6 6 6 6 6 6 6 6 6 6
6 6 6 6 6 6 6 37 37 37 37 37 37 6 6 6 6 6 6 6 6 6 6 6 6 6 6 6 6 6 6 6 6 6 6 6 6 6 6 6 6 6 6 6 6 6 6 6 6 6 6 6 6 6 6
6 6 6 6 6 6 6 37 37 37 37 37 37 37 6 6 6 6 6 6 6 6 6 6 6 6 6 6 6 6 6 6 6 6 6 6 6 6 6 6 6 6 6 6 6 6 6 6 6 6 6 6 6 6 6
6 6 6 6 6 6 37 37 37 37 37 37 37 37 6 6 6 6 6 6 6 6 6 6 6 6 6 6 42 6 6 6 6 6 6 6 6 6 6 6 6 6 6 6 6 6 6 6 6 6 6 6 6 6 6
6 6 6 6 6 6 37 37 37 37 37 37 37 37 37 6 6 6 6 6 6 6 6 6 6 6 6 6 6 13 6 6 6 6 6 6 6 6 6 6 6 6 6 6 6 6 6 6 6 6 6 6 6 6 6
6 6 6 6 6 37 37 37 37 37 37 37 37 37 37 6 6 6 6 6 6 6 6 6 6 6 6 6 13 13 6 6 6 6 6 6 6 6 6 6 6 6 6 6 6 6 6 6 6 6 6 6 6 6 6
6 6 6 6 6 37 37 37 37 37 37 37 37 37 37 37 6 6 6 6 6 6 6 6 6 6 6 6 13 13 42 6 6 6 6 6 6 6 6 6 6 6 6 6 6 6 6 6 6 6 6 6 6 6 6
6 6 6 6 37 37 37 37 37 37 37 37 37 37 37 37 6 6 6 6 6 6 6 6 6 6 6 13 13 42 6 6 6 6 6 6 6 6 6 6 6 6 6 6 6 6 6 6 6 6 6 6 6 6 6
6 6 6 6 37 37 37 37 37 37 37 37 37 37 37 37 37 6 6 6 6 6 6 6 6 6 6 13 13 42 6 6 6 6 6 6 6 6 6 6 6 6 6 6 6 6 6 6 6 6 6 6 6 6 6
6 6 6 37 37 37 37 37 37 37 37 37 37 37 37 37 37 6 6 6 6 6 6 6 6 6 13 13 45 42 6 6 6 6 6 6 6 6 6 6 6 6 6 6 6 6 6 6 6 6 6 6 6 6 6
6 6 6 37 37 37 37 37 37 37 37 37 37 37 37 37 37 37 6 6 6 6 6 6 6 6 13 13 45 45 42 6 6 6 6 6 6 6 6 6 6 6 6 6 6 6 6 6 6 6 6 6 6 6 6
6 6 37 37 37 37 37 37 37 37 37 37 37 37 37 37 37 37 6 6 6 6 6 6 6 13 13 42 45 45 42 6 6 6 6 6 6 6 6 6 6 6 6 6 6 6 6 6 6 6 6 6 6 6 6
6 6 37 37 37 37 37 37 37 37 37 37 37 37 37 37 37 37 37 6 6 6 6 6 6 13 13 42 6 45 45 42 6 6 6 6 6 6 6 6 6 6 6 6 6 6 6 6 6 6 6 6 6 6 6
6 37 37 37 37 37 37 37 37 37 37 37 37 37 37 37 37 37 37 6 6 6 6 6 13 13 42 6 6 45 45 42 6 6 6 6 6 6 6 6 6 6 6 6 6 6 6 6 6 6 6 6 6 6 6
6 37 37 37 37 37 37 37 37 37 37 37 37 37 37 37 37 37 37 37 6 6 6 6 13 13 42 6 6 6 45 45 42 6 6 6 6 6 6 6 6 6 6 6 6 6 6 6 6 6 6 6 6 6 6
6 37 37 37 37 37 37 37 37 37 37 37 37 37 37 37 37 37 37 37 6 6 6 13 13 42 6 6 6 6 45 45 42 6 6 6 6 6 6 6 6 6 6 6 6 6 6 6 6 6 6 6 6 6 6
6 6 37 37 37 37 37 37 37 37 37 37 37 37 37 37 37 37 37 37 6 6 42 13 13 42 6 6 6 6 6 45 45 42 6 6 6 6 6 6 6 6 6 6 6 6 6 6 6 6 6 6 6 6 6
6 6 37 37 37 37 37 37 37 37 37 37 37 37 37 37 37 37 37 6 6 42 13 13 42 6 6 6 6 6 6 45 45 42 6 6 6 6 6 6 6 6 6 6 6 6 6 6 6 6 6 6 6 6 6
6 6 6 37 37 37 37 37 37 37 37 37 37 37 37 37 37 37 37 6 6 42 13 13 42 6 6 6 6 6 6 6 45 45 42 6 6 6 6 6 6 6 6 6 6 6 6 6 6 6 6 6 6 6 6
6 6 6 37 37 37 37 37 37 37 37 37 37 37 37 37 37 37 6 6 42 13 13 42 6 6 6 6 6 6 6 6 45 45 42 6 6 6 6 6 6 6 6 6 6 6 6 6 6 6 6 6 6 6 6
6 6 6 6 37 37 37 37 37 37 37 37 37 37 37 37 37 37 6 6 42 13 13 42 6 6 6 6 6 6 6 6 6 45 45 42 6 6 6 6 6 6 6 6 6 6 6 6 6 6 6 6 6 6 6
42 6 6 6 37 37 37 37 37 37 37 37 37 37 37 37 37 6 6 42 13 13 45 42 6 6 6 6 6 6 6 6 6 45 45 42 6 6 6 6 6 6 6 6 6 6 6 6 6 6 6 6 6 6 6
6 42 6 6 6 37 37 37 37 37 37 37 37 37 37 37 37 6 6 42 13 13 42 45 6 6 6 6 6 6 6 6 6 6 45 45 42 6 6 6 6 6 6 6 6 6 6 6 6 6 6 6 6 6 6
45 42 6 6 6 37 37 37 37 37 37 37 37 37 37 37 6 6 42 13 13 42 42 45 6 6 6 6 6 6 6 6 6 6 45 45 6 6 6 6 6 6 6 6 6 6 6 6 6 6 6 6 6 6 6
6 45 42 6 6 6 37 37 37 37 37 37 37 37 37 37 6 6 42 13 13 42 6 42 45 6 6 6 6 42 6 6 6 6 6 45 45 6 6 6 6 6 6 6 6 6 6 6 6 6 6 6 6 6 6
45 45 42 6 6 6 37 37 37 37 37 37 37 37 37 6 6 42 13 13 42 6 6 42 45 42 6 6 42 42 6 6 6 6 42 45 45 6 6 6 6 6 6 6 6 6 6 6 6 6 6 6 6 6 6
6 45 45 42 6 6 6 37 37 37 37 37 37 37 37 6 6 42 13 13 42 6 6 6 42 45 42 6 42 13 42 6 6 6 6 13 45 45 6 6 6 6 6 6 6 6 6 6 6 6 6 6 6 6 6
42 45 45 42 6 6 6 37 37 37 37 37 37 37 42 6 42 13 13 42 6 6 6 6 42 45 42 42 13 13 42 6 6 6 13 13 45 45 6 6 6 6 6 6 6 6 6 6 6 6 6 6 6 6 6
6 42 45 45 42 6 6 6 37 37 37 37 37 37 45 42 42 13 13 42 6 6 6 6 6 42 45 42 13 13 45 42 6 6 13 13 42 45 45 6 6 6 6 6 6 6 6 6 6 6 6 6 6 6 6
42 42 45 45 42 6 6 6 37 37 37 37 37 45 45 42 13 13 42 6 6 6 6 6 6 42 45 13 13 45 45 42 6 13 13 6 42 45 45 6 6 6 6 6 6 6 6 6 6 6 6 6 6 6 6
6 42 42 45 45 42 6 6 6 37 37 37 37 45 45 45 13 13 42 6 6 6 6 6 6 6 42 13 13 6 45 45 42 13 13 6 6 42 45 45 42 6 6 6 6 6 6 6 6 6 6 6 6 6 6
6 42 42 45 45 42 6 6 6 37 37 37 42 45 45 13 13 42 6 6 6 6 6 6 6 42 45 13 6 6 45 45 13 13 6 6 6 42 45 45 42 6 6 6 6 6 6 6 6 6 6 6 6 6 6
6 6 42 42 45 45 42 6 6 6 37 37 6 42 45 13 13 42 45 6 6 6 6 6 6 42 45 45 6 6 6 45 13 13 6 6 6 6 42 45 45 42 6 6 6 6 6 6 6 6 6 6 6 6 6
6 6 42 42 45 45 42 6 6 6 37 6 6 42 13 13 42 45 45 6 6 6 6 6 6 42 45 45 6 6 6 13 13 6 6 6 6 6 42 45 45 6 6 6 6 6 6 6 6 6 6 6 6 6 6
6 6 6 42 42 45 45 42 6 6 6 6 6 42 13 13 42 42 45 45 6 6 6 6 6 6 42 45 45 6 6 13 13 6 6 6 6 6 6 42 45 45 13 6 6 6 6 6 6 6 6 6 6 6 6
6 6 6 42 42 45 45 42 6 6 6 6 42 13 13 42 6 42 45 45 42 6 6 6 6 6 42 45 45 6 13 13 45 6 6 6 6 6 6 42 45 45 6 6 6 6 6 6 6 6 6 6 6 6 6
6 6 6 6 42 42 45 45 42 6 6 6 42 13 13 42 6 6 42 45 45 42 6 6 6 6 6 42 45 45 13 13 42 45 6 6 6 6 6 42 42 45 45 6 6 6 6 6 6 6 6 6 6 6 6
6 6 6 6 42 42 45 45 42 6 6 42 13 13 42 6 6 6 42 45 45 42 6 6 6 6 6 42 45 45 13 42 42 45 6 6 42 6 42 13 42 45 45 6 6 6 6 6 6 6 6 6 6 6 6
6 6 6 6 6 42 42 45 45 42 6 42 13 13 42 6 6 6 6 42 45 45 42 6 6 6 6 6 42 45 45 42 6 42 45 6 42 42 42 13 6 42 45 45 42 6 6 6 6 6 6 6 6 6 6
6 6 6 6 6 42 42 45 45 42 42 13 13 42 6 6 6 6 6 42 45 45 6 6 6 6 6 6 42 45 42 6 6 42 45 42 45 42 13 6 6 42 45 45 42 6 6 6 6 6 6 6 6 6 6
6 6 6 6 6 6 42 42 45 45 42 13 13 42 6 6 6 6 6 6 42 45 45 6 6 6 6 6 6 42 42 6 6 6 42 45 6 45 13 6 6 6 42 45 45 42 6 6 6 6 6 6 6 6 6
6 6 6 6 6 6 42 42 45 45 13 13 42 6 6 6 6 6 6 6 42 45 45 6 6 6 6 6 6 42 6 6 6 6 42 6 6 45 42 6 6 6 42 45 45 42 6 6 6 6 6 6 6 6 6
6 6 6 6 6 6 6 42 42 45 45 13 42 6 6 6 6 6 6 6 6 42 45 45 6 6 6 6 6 6 6 6 6 6 42 13 6 6 45 42 6 6 6 42 45 45 42 6 6 6 6 6 6 6 6
6 6 6 6 6 6 6 42 42 45 45 42 6 6 6 6 6 6 6 6 6 42 45 45 42 6 6 6 6 6 6 6 6 42 13 6 6 6 45 42 6 6 6 42 45 45 13 6 6 6 6 6 6 6 6
6 6 6 6 6 6 6 6 42 13 45 45 42 6 6 6 6 6 6 6 6 6 42 45 45 42 6 6 6 6 6 6 6 42 13 6 6 6 13 42 6 6 6 6 42 45 45 42 6 6 6 6 6 6 6
6 6 6 6 6 6 6 42 13 13 45 45 42 6 6 6 6 6 6 6 6 6 42 45 45 42 6 6 6 6 6 6 6 42 45 6 6 13 42 6 6 6 6 6 42 45 45 42 6 6 6 6 6 6 6
6 6 6 6 6 6 6 42 13 13 42 45 45 42 6 6 6 6 6 6 6 6 6 42 45 45 42 6 6 6 6 6 6 6 42 45 6 13 42 6 6 6 6 6 6 42 45 45 42 6 6 6 6 6 6
6 6 6 6 6 6 42 13 13 42 42 45 45 42 6 6 6 6 6 6 6 6 6 42 45 45 42 6 6 6 6 6 6 6 42 45 13 42 6 6 6 6 6 6 6 42 45 45 42 6 6 6 6 6 6
6 6 6 6 6 6 42 13 13 42 6 42 45 45 42 6 6 6 6 6 6 6 6 6 42 45 45 42 6 6 6 6 6 6 42 13 13 42 42 6 6 6 6 6 6 6 42 45 45 42 6 6 6 6 6
6 6 6 6 6 42 13 13 42 6 6 42 45 45 42 6 6 6 6 6 6 6 6 6 42 45 45 42 6 6 6 6 6 42 45 42 42 42 42 6 6 6 6 6 6 6 42 45 45 42 6 6 6 6 6
6 6 6 42 6 42 13 13 42 6 6 6 42 45 45 13 6 6 6 6 6 6 6 6 6 42 45 45 42 6 6 6 6 6 42 45 42 42 45 6 6 6 6 6 6 6 6 42 45 45 42 6 6 6 6
6 6 42 42 42 13 13 42 6 6 6 6 42 45 45 42 6 6 6 6 6 6 6 6 6 42 45 45 42 6 6 6 6 6 42 45 42 13 45 6 6 45 42 6 6 6 42 13 45 42 1 6 6 6 6
6 6 42 30 42 13 13 42 6 6 6 6 6 42 45 45 42 6 6 6 6 6 6 6 6 6 42 45 45 42 6 6 6 6 6 42 45 13 42 45 6 6 45 42 6 6 42 13 13 42 1 1 6 6 6
6 42 30 30 13 13 42 6 6 6 6 6 6 42 45 45 42 6 6 6 6 6 6 6 6 6 42 45 45 42 6 6 6 6 6 42 13 42 42 45 6 42 45 42 6 42 13 13 42 1 1 1 6 6 6
6 42 30 6 30 13 42 6 6 6 6 6 6 6 42 45 45 42 6 6 6 6 6 6 6 6 6 42 45 45 42 42 6 6 6 42 13 42 6 42 45 42 42 45 42 42 13 13 42 1 1 1 1 6 6
42 30 6 6 30 42 6 6 6 6 6 6 6 6 42 45 45 42 6 6 6 6 6 6 6 6 6 42 45 45 42 13 6 6 42 13 42 6 6 42 45 42 42 45 42 13 13 42 1 1 1 1 1 6 6
6 42 30 6 30 42 6 6 6 6 6 6 6 6 6 42 45 45 42 6 6 6 6 6 6 6 6 6 42 45 45 42 42 6 42 13 42 6 6 6 42 45 42 42 45 13 13 42 1 1 1 1 1 1 6
6 42 30 30 42 6 6 6 6 6 6 6 6 6 42 13 45 45 13 6 6 6 6 6 6 6 6 6 42 45 45 42 6 42 13 42 6 6 6 6 42 45 42 42 13 13 42 1 1 1 1 1 1 1 6
6 6 42 30 42 6 6 6 6 6 6 6 6 6 42 13 13 45 45 42 6 6 6 6 6 6 6 6 6 42 45 45 42 42 13 42 6 6 6 6 6 42 45 42 13 13 42 1 1 1 1 1 1 1 6
6 6 42 42 6 6 6 6 6 6 6 6 6 42 13 13 42 45 45 42 6 6 6 6 6 6 6 6 6 42 45 45 42 13 42 6 6 6 6 6 6 42 45 13 13 42 1 1 1 1 1 1 1 1 6
6 6 6 42 6 6 6 6 6 6 6 6 6 6 13 13 42 42 45 45 42 6 6 6 6 6 6 6 6 6 42 45 45 13 42 6 6 6 6 6 6 6 42 13 13 42 1 1 1 1 1 1 1 1 6
6 6 6 6 6 6 6 6 6 6 6 6 6 13 13 42 6 42 45 45 42 6 6 6 6 6 6 6 6 6 42 45 45 42 6 6 6 6 6 6 6 42 13 13 42 1 1 1 1 1 1 1 1 1 6
6 6 6 6 6 6 6 6 6 6 6 6 6 13 13 42 6 6 42 45 45 42 6 6 6 6 6 6 6 6 6 42 45 45 42 6 6 6 6 6 6 42 13 13 42 1 1 1 1 1 1 1 1 1 6
6 6 6 6 6 6 6 6 6 6 6 6 13 13 42 6 6 6 42 45 45 42 6 6 6 6 6 6 6 6 6 42 45 45 42 6 6 6 6 6 42 13 13 42 1 1 1 1 1 1 1 1 1 1 6
6 6 6 6 6 6 6 6 6 6 6 42 13 13 42 6 6 6 6 42 45 45 13 6 6 6 6 6 6 6 6 6 42 45 45 42 6 6 6 6 42 13 13 42 1 1 1 1 1 1 1 1 1 1 6
6 6 6 6 6 6 6 6 6 6 42 13 13 42 6 6 6 6 6 42 45 45 42 6 6 6 6 6 6 6 6 6 42 45 45 42 6 6 6 42 13 13 42 1 1 1 1 1 1 1 1 1 1 1 6
6 6 6 6 6 6 6 6 6 6 42 13 13 42 6 6 6 6 6 6 42 45 45 42 6 6 6 6 6 6 6 6 6 42 45 45 42 6 6 42 13 13 42 1 1 1 1 1 1 1 1 1 1 1 6
6 6 6 6 6 6 6 6 6 42 13 13 42 6 6 6 37 6 6 6 42 45 45 42 6 6 6 6 6 6 6 6 6 42 45 45 42 6 42 13 13 42 1 1 1 1 1 1 1 1 1 1 1 1 6
6 6 6 6 6 6 6 6 6 42 13 13 42 6 6 6 37 37 6 6 6 42 45 45 42 6 6 6 6 6 6 6 6 6 42 45 45 42 42 13 13 42 1 1 1 1 1 1 1 1 1 1 1 1 1
6 6 6 6 6 6 6 6 42 13 13 42 6 6 6 37 37 37 6 6 6 42 45 45 42 6 6 6 6 6 6 6 6 6 42 45 45 42 13 13 42 1 1 1 1 1 1 1 1 1 1 1 1 1 6
6 6 6 6 6 6 6 6 42 13 13 42 6 6 6 37 37 37 37 6 6 6 42 45 45 6 6 6 6 6 6 6 6 6 6 42 45 45 13 13 42 1 1 1 1 1 1 1 1 1 1 1 1 1 6
6 6 6 6 6 6 6 42 13 13 42 6 6 6 37 37 37 37 37 6 6 6 42 45 45 6 6 6 6 6 6 6 6 6 6 42 45 45 13 42 1 1 1 1 1 1 1 1 1 1 1 1 1 1 6
6 6 6 6 6 6 6 42 13 13 42 6 6 6 37 37 37 37 37 37 6 6 6 42 45 45 6 6 6 6 6 6 6 6 6 6 42 45 45 42 1 1 1 1 1 1 1 1 1 1 1 1 1 1 6
6 6 6 6 6 6 42 13 13 42 6 6 6 37 37 37 37 37 37 37 6 6 6 42 45 45 6 6 6 6 6 6 6 6 6 6 42 45 42 1 1 1 1 1 1 1 1 1 1 1 1 1 1 1 6
6 6 6 6 6 6 42 13 13 42 6 6 6 37 37 37 37 37 37 37 37 6 6 6 42 45 45 42 6 6 6 6 6 6 6 6 6 42 42 1 1 1 1 1 1 1 1 1 1 1 1 1 1 1 6
6 6 6 6 6 42 13 13 42 6 6 6 37 37 37 37 37 37 37 37 37 6 6 6 42 45 45 42 6 6 6 6 6 6 6 6 6 42 1 1 1 1 1 1 1 1 1 1 1 1 1 1 1 1 6
6 6 6 6 6 42 13 13 42 6 6 6 37 37 37 37 37 37 37 37 37 37 6 6 6 42 45 45 42 6 6 6 6 6 6 6 6 6 1 1 1 1 1 1 1 1 1 1 1 1 1 1 1 1 6
6 6 6 6 42 13 13 42 6 6 6 37 37 37 37 37 37 37 37 37 37 37 6 6 6 42 45 45 42 13 6 6 6 6 6 6 6 6 1 1 1 1 1 1 1 1 1 1 1 1 1 1 1 1 6
6 6 6 6 42 13 13 42 6 6 6 37 37 37 37 37 37 37 37 37 37 37 37 6 6 6 42 45 45 13 6 6 6 6 6 6 6 6 6 1 1 1 1 1 1 1 1 1 1 1 1 1 1 1 6
6 6 6 42 13 13 42 6 6 6 37 37 37 37 37 37 37 37 37 37 37 37 37 6 6 6 42 45 45 42 6 6 6 6 6 6 6 6 6 1 1 1 1 1 1 1 1 1 1 1 1 1 1 1 6
6 6 6 42 13 13 42 6 6 6 37 37 37 37 37 37 37 37 37 37 37 37 37 37 6 6 6 42 45 45 42 6 6 6 6 6 6 6 6 6 1 1 1 1 1 1 1 1 1 1 1 1 1 1 6
6 6 42 13 13 42 6 6 6 37 37 37 37 37 37 37 37 37 37 37 37 37 37 37 6 6 6 42 45 45 42 6 6 6 6 6 6 6 6 6 1 1 1 1 1 1 1 1 1 1 1 1 1 1 6
6 6 42 13 13 42 6 6 6 37 37 37 37 37 37 37 37 37 37 37 37 37 37 37 37 6 6 6 42 45 45 42 6 6 6 6 6 6 6 6 6 1 1 1 1 1 1 1 1 1 1 1 1 1 6
6 42 13 13 42 6 6 6 37 37 37 37 37 37 37 37 37 37 37 37 37 37 37 37 37 6 6 6 42 45 45 42 13 6 6 6 6 6 6 6 6 1 1 1 1 1 1 1 1 1 1 1 1 1 6
6 42 13 13 42 6 6 6 37 37 37 37 37 37 37 37 37 37 37 37 37 37 37 37 37 37 6 6 6 42 45 45 13 6 6 6 6 6 6 6 6 6 1 1 1 1 1 1 1 1 1 1 1 1 6
42 13 13 42 6 6 6 37 37 37 37 37 37 37 37 37 37 37 37 37 37 37 37 37 37 37 6 6 6 42 45 45 42 6 6 6 6 6 6 6 6 6 1 1 1 1 1 1 1 1 1 1 1 1 6
6 13 13 42 6 6 6 37 37 37 37 37 37 37 37 37 37 37 37 37 37 37 37 37 37 37 37 6 6 6 42 45 45 42 6 6 6 6 6 6 6 6 6 1 1 1 1 1 1 1 1 1 1 1 6
13 13 42 6 6 6 37 37 37 37 37 37 37 37 37 37 37 37 37 37 37 37 37 37 37 37 37 6 6 6 42 45 45 42 6 6 6 6 6 6 6 6 6 1 1 1 1 1 1 1 1 1 1 1 6
6 13 42 6 6 6 37 37 37 37 37 37 37 37 37 37 37 37 37 37 37 37 37 37 37 37 37 37 6 6 6 42 45 45 42 6 6 6 6 6 6 6 6 6 1 1 1 1 1 1 1 1 1 1 6
13 42 6 6 6 37 37 37 37 37 37 37 37 37 37 37 37 37 37 37 37 37 37 37 37 37 37 37 6 6 6 42 45 45 42 6 6 6 6 6 6 6 6 6 1 1 1 1 1 1 1 1 1 1 6
6 42 6 6 6 37 37 37 37 37 37 37 37 37 37 37 37 37 37 37 37 37 37 37 37 37 37 37 37 6 6 6 42 45 45 42 6 6 6 6 6 6 6 6 6 1 1 1 1 1 1 1 1 1 6
42 6 6 6 37 37 37 37 37 37 37 37 37 37 37 37 37 37 37 37 37 37 37 37 37 37 37 37 37 6 6 6 42 45 45 42 6 6 6 6 6 6 6 6 6 1 1 1 1 1 1 1 1 1 6
6 6 6 6 37 37 37 37 37 37 37 37 37 37 37 37 37 37 37 37 37 37 37 37 37 37 37 37 37 37 6 6 6 42 45 45 42 6 6 6 6 6 6 6 6 6 1 1 1 1 1 1 1 1 6
6 6 6 37 37 37 37 37 37 37 37 37 37 37 37 37 37 37 37 37 37 37 37 37 37 37 37 37 37 37 6 6 6 42 45 45 42 6 6 6 6 6 6 6 6 6 1 1 1 1 1 1 1 1 6
6 6 6 6 37 37 37 37 37 37 37 37 37 37 37 37 37 37 37 37 37 37 37 37 37 37 37 37 37 37 37 6 6 6 42 45 45 42 6 6 6 6 6 6 6 6 6 1 1 1 1 1 1 1 6
6 6 6 6 37 37 37 37 37 37 37 37 37 37 37 37 37 37 37 37 37 37 37 37 37 37 37 37 37 37 6 6 6 6 42 45 45 42 6 6 6 6 6 6 6 6 6 1 1 1 1 1 1 1 6
6 6 6 6 6 37 37 37 37 37 37 37 37 37 37 37 37 37 37 37 37 37 37 37 37 37 37 37 37 37 6 6 6 6 6 42 45 45 42 6 6 6 6 6 6 6 6 6 1 1 1 1 1 1 6
6 6 6 6 6 37 37 37 37 37 37 37 37 37 37 37 37 37 37 37 37 37 37 37 37 37 37 37 37 6 6 6 6 6 6 42 45 45 42 6 6 6 6 6 6 6 6 6 1 1 1 1 1 1 6
6 6 6 6 6 6 37 37 37 37 37 37 37 37 37 37 37 37 37 37 37 37 37 37 37 37 37 37 37 6 6 6 6 6 6 6 42 45 45 42 6 6 6 6 6 6 6 6 6 1 1 1 1 1 6
6 6 6 6 6 6 37 37 37 37 37 37 37 37 37 37 37 37 37 37 37 37 37 37 37 37 37 37 6 6 6 6 6 6 6 6 42 45 45 42 6 6 6 6 6 6 6 6 6 1 1 1 1 1 6
6 6 6 6 6 6 6 37 37 37 37 37 37 37 37 37 37 37 37 37 37 37 37 37 37 37 37 37 6 6 6 6 6 6 6 6 6 42 45 45 42 6 6 6 6 6 6 6 6 6 1 1 1 1 6
6 6 6 6 6 6 6 37 37 37 37 37 37 37 37 37 37 37 37 37 37 37 37 37 37 37 37 6 6 6 6 6 6 6 6 6 6 42 45 45 42 6 6 6 6 6 6 6 6 6 1 1 1 1 6
6 6 6 6 6 6 6 6 37 37 37 37 37 37 37 37 37 37 37 37 37 37 37 37 37 37 37 6 6 6 6 6 6 6 6 6 6 6 42 45 45 42 6 6 6 6 6 6 6 6 6 1 1 1 6
6 6 6 6 6 6 6 6 37 37 37 37 37 37 37 37 37 37 37 37 37 37 37 37 37 37 6 6 6 6 6 6 6 6 6 6 6 6 42 45 45 42 6 6 6 6 6 6 6 6 6 1 1 1 6
6 6 6 6 6 6 6 6 6 37 37 37 37 37 37 37 37 37 37 37 37 37 37 37 37 37 6 6 6 6 6 6 6 6 6 6 6 6 6 42 45 45 42 6 6 6 6 6 6 6 6 6 1 1 6
6 6 6 6 6 6 6 6 6 37 37 37 37 37 37 37 37 37 37 37 37 37 37 37 37 6 6 6 6 6 6 6 6 6 6 6 6 6 6 42 45 45 42 6 6 6 6 6 6 6 6 6 1 1 6
6 6 6 6 6 6 6 6 6 6 37 37 37 37 37 37 37 37 37 37 37 37 37 37 37 6 6 6 6 6 6 6 6 6 6 6 6 6 6 6 42 45 45 42 6 6 6 6 6 6 6 6 6 1 6
6 6 6 6 6 6 6 6 6 6 37 37 37 37 37 37 37 37 37 37 37 37 37 37 6 6 6 6 6 6 6 6 6 6 6 6 6 6 6 6 42 45 45 42 6 6 6 6 6 6 6 6 6 1 6
6 6 6 6 6 6 6 6 6 6 6 37 37 37 37 37 37 37 37 37 37 37 37 37 6 6 6 6 6 6 6 6 6 6 6 6 6 6 6 6 6 42 45 45 42 6 6 6 6 6 6 6 6 6 6
6 6 6 6 6 6 6 6 6 6 6 37 37 37 37 37 37 37 37 37 37 37 37 6 6 6 6 6 6 6 6 6 6 6 6 6 6 6 6 6 6 42 45 45 42 6 6 6 6 6 6 6 6 6 6
6 6 6 6 6 6 6 6 6 6 6 6 37 37 37 37 37 37 37 37 37 37 37 6 6 6 6 6 6 6 6 6 6 6 6 6 6 6 6 6 6 6 42 45 45 42 6 6 6 6 6 6 6 6 6
6 6 6 6 6 6 6 6 6 6 6 6 37 37 37 37 37 37 37 37 37 37 6 6 6 6 6 6 6 6 6 6 6 6 6 6 6 6 6 6 6 6 42 45 45 42 6 6 6 6 6 6 6 6 6
6 6 6 6 6 6 6 6 6 6 6 6 6 37 37 37 37 37 37 37 37 37 6 6 6 6 6 6 6 6 6 6 6 6 6 6 6 6 6 6 6 6 6 42 45 45 42 6 6 6 6 6 6 6 6
6 6 6 6 6 6 6 6 6 6 6 6 6 37 37 37 37 37 37 37 37 6 6 6 6 6 6 6 6 6 6 6 6 6 6 6 6 6 6 6 6 6 6 42 45 45 42 6 6 6 6 6 6 6 6
6 6 6 6 6 6 6 6 6 6 6 6 6 6 37 37 37 37 37 37 37 6 6 6 6 6 6 6 6 6 6 6 6 6 6 6 6 6 6 6 6 6 6 6 42 45 45 42 6 6 6 6 6 6 6
6 6 6 6 6 6 6 6 6 6 6 6 6 6 37 37 37 37 37 37 6 6 6 6 6 6 6 6 6 6 6 6 6 6 6 6 6 6 6 6 6 6 6 6 42 45 45 42 6 6 6 6 6 6 6
6 6 6 6 6 6 6 6 6 6 6 6 6 6 6 37 37 37 37 37 6 6 6 6 6 6 6 6 6 6 6 6 6 6 6 6 6 6 6 6 6 6 6 6 6 42 45 45 42 6 6 6 6 6 6
6 6 6 6 6 6 6 6 6 6 6 6 6 6 6 37 37 37 37 6 6 6 6 6 6 6 6 6 6 6 6 6 6 6 6 6 6 6 6 6 6 6 6 6 6 42 45 45 42 6 6 6 6 6 6
6 6 6 6 6 6 6 6 6 6 6 6 6 6 6 6 37 37 37 6 6 6 6 6 6 6 6 6 6 6 6 6 6 6 6 6 6 6 6 6 6 6 6 6 6 6 42 45 45 42 6 6 6 6 6
6 6 6 6 6 6 6 6 6 6 6 6 6 6 6 6 37 37 6 6 6 6 6 6 6 6 6 6 6 6 6 6 6 6 6 6 6 6 6 6 6 6 6 6 6 6 42 45 45 42 6 6 6 6 6
6 6 6 6 6 6 6 6 6 6 6 6 6 6 6 6 6 37 6 6 6 6 6 6 6 6 6 6 6 6 6 6 6 6 6 6 6 6 6 6 6 6 6 6 6 6 6 42 45 45 42 6 6 6 6
6 6 6 6 6 6 6 6 6 6 6 6 6 6 6 6 6 6 6 6 6 6 6 6 6 6 6 6 6 6 6 6 6 6 6 6 6 6 6 6 6 6 6 6 6 6 6 42 45 45 42 6 6 6 6
6 6 6 6 6 6 6 6 6 6 6 6 6 6 6 6 6 6 6 6 6 6 6 6 6 6 6 6 6 6 6 6 6 6 6 6 6 6 6 6 6 6 6 6 6 6 6 6 42 45 45 42 6 6 6
6 6 6 6 6 6 6 6 6 6 6 6 6 6 6 6 6 6 6 6 6 6 6 6 6 6 6 6 6 6 6 6 6 6 6 6 6 6 6 6 6 6 6 6 6 6 6 6 42 45 45 42 6 6 6
6 6 6 6 6 6 6 6 6 6 6 6 6 6 6 6 6 6 6 6 6 6 6 6 6 6 6 6 6 6 6 6 6 6 6 6 6 6 6 6 6 6 6 6 6 6 6 6 6 42 45 45 42 6 6
6 6 6 6 6 6 6 6 6 6 6 6 6 6 6 6 6 6 6 6 6 6 6 6 6 6 6 6 6 6 6 6 6 6 6 6 6 6 6 6 6 6 6 6 6 6 6 6 6 42 45 45 42 6 6
6 6 6 6 6 6 6 6 6 6 6 6 6 6 6 6 6 6 6 6 6 6 6 6 6 6 6 6 6 6 6 6 6 6 6 6 6 6 6 6 6 6 6 6 6 6 6 6 6 6 42 45 45 42 6
6 6 6 6 6 6 6 6 6 6 6 6 6 6 6 6 6 6 6 6 6 6 6 6 6 6 6 6 6 6 6 6 6 6 6 6 6 6 6 6 6 6 6 6 6 6 6 6 6 6 42 45 45 42 6
6 6 6 6 6 6 6 6 6 6 6 6 6 6 6 6 6 6 6 6 6 6 6 6 6 6 6 6 6 6 6 6 6 6 6 6 6 6 6 6 6 6 6 6 6 6 6 6 6 6 6 42 45 45 6
6 6 6 6 6 6 6 6 6 6 6 6 6 6 6 6 6 6 6 6 6 6 6 6 6 6 6 6 6 6 6 6 6 6 6 6 6 6 6 6 6 6 6 6 6 6 6 6 6 6 6 42 45 45 6
6 6 6 6 6 6 6 6 6 6 6 6 6 6 6 6 6 6 6 6 6 6 6 6 6 6 6 6 6 6 6 6 6 6 6 6 6 6 6 6 6 6 6 6 6 6 6 6 6 6 6 6 42 45 6
6 6 6 6 6 6 6 6 6 6 6 6 6 6 6 6 6 6 6 6 6 6 6 6 6 6 6 6 6 6 6 6 6 6 6 6 6 6 6 6 6 6 6 6 6 6 6 6 6 6 6 6 42 45 6
6 6 6 6 6 6 6 6 6 6 6 6 6 6 6 6 6 6 6 6 6 6 6 6 6 6 6 6 6 6 6 6 6 6 6 6 6 6 6 6 6 6 6 6 6 6 6 6 6 6 6 6 6 42 6
6 6 6 6 6 6 6 6 6 6 6 6 6 6 6 6 6 6 6 6 6 6 6 6 6 6 6 6 6 6 6 6 6 6 6 6 6 6 6 6 6 6 6 6 6 6 6 6 6 6 6 6 6 42 6
6 6 6 6 6 6 6 6 6 6 6 6 6 6 6 6 6 6 6 6 6 6 6 6 6 6 6 6 6 6 6 6 6 6 6 6 6 6 6 6 6 6 6 6 6 6 6 6 6 6 6 6 6 6 6
6 6 6 6 6 6 6 6 6 6 6 6 6 6 6 6 6 6 6 6 6 6 6 6 6 6 6 6 6 6 6 6 6 6 6 6 6 6 6 6 6 6 6 6 6 6 6 6 6 6 6 6 6 6 6
6 6 6 6 6 6 6 6 6 6 6 6 6 6 6 6 6 6 6 6 6 6 6 6 6 6 6 6 6 6 6 6 6 6 6 6 6 6 6 6 6 6 6 6 6 6 6 6 6 6 6 6 6 6 6
6 6 6 6 6 6 6 6 6 6 6 6 6 6 6 6 6 6 6 6 6 6 6 6 6 6 6 6 6 6 6 6 6 6 6 6 6 6 6 6 6 6 6 6 6 6 6 6 6 6 6 6 6 6 6
6 6 6 6 6 6 6 6 6 6 6 6 6 6 6 6 6 6 6 6 6 6 6 6 6 6 6 6 6 6 6 6 6 6 6 6 6 6 6 6 6 6 6 6 6 6 6 6 6 6 6 6 6 6 6
6 6 6 6 6 6 6 6 6 6 6 6 6 6 6 6 6 6 6 6 6 6 6 6 6 6 6 6 6 6 6 6 6 6 6 6 6 6 6 6 6 6 6 6 6 6 6 6 6 6 6 6 6 6 6
6 6 6 6 6 6 6 6 6 6 6 6 6 6 6 6 6 6 6 6 6 6 6 6 6 6 6 6 6 6 6 6 6 6 6 6 6 6 6 6 6 6 6 6 6 6 6 6 6 6 6 6 6 6 6
6 6 6 6 6 6 6 6 6 6 6 6 6 6 6 6 6 6 6 6 6 6 6 6 6 6 6 6 6 6 6 6 6 6 6 6 6 6 6 6 6 6 6 6 6 6 6 6 6 6 6 6 6 6 6
6 6 6 6 6 6 6 6 6 6 6 6 6 6 6 6 6 6 6 6 6 6 6 6 6 6 6 6 6 6 6 6 6 6 6 6 6 6 6 6 6 6 6 6 6 6 6 6 6 6 6 6 6 6 6
6 6 6 6 6 6 6 6 6 6 6 6 6 6 6 6 6 6 6 6 6 6 6 6 6 6 6 6 6 6 6 6 6 6 6 6 6 6 6 6 6 6 6 6 6 6 6 6 6 6 6 6 6 6 6
6 6 6 6 6 6 6 6 6 6 6 6 6 6 6 6 6 6 6 6 6 6 6 6 6 6 6 6 6 6 6 6 6 6 6 6 6 6 6 6 6 6 6 6 6 6 6 6 6 6 6 6 6 6 6
6 6 6 6 6 6 6 6 6 6 6 6 6 6 6 6 6 6 6 6 6 6 6 6 6 6 6 6 6 6 6 6 6 6 6 6 6 6 6 6 6 6 6 6 6 6 6 6 6 6 6 6 6 6 6
6 6 6 6 6 6 6 6 6 6 6 6 6 6 6 6 6 6 6 6 6 6 6 6 6 6 6 6 6 6 6 6 6 6 6 6 6 6 6 6 6 6 6 6 6 6 6 6 6 6 6 6 6 6 6
6 6 6 6 6 6 6 6 6 6 6 6 6 6 6 6 6 6 6 6 6 6 6 6 6 6 6 6 6 6 6 6 6 6 6 6 6 6 6 6 6 6 6 6 6 6 6 6 6 6 6 6 6 6 6
6 6 6 6 6 6 6 6 6 6 6 6 6 6 6 6 6 6 6 6 6 6 6 6 6 6 6 6 6 6 6 6 6 6 6 6 6 6 6 6 6 6 6 6 6 6 6 6 6 6 6 6 6 6 6
6 6 6 6 6 6 6 6 6 6 6 6 6 6 6 6 6 6 6 6 6 6 6 6 6 6 6 6 6 6 6 6 6 6 6 6 6 6 6 6 6 6 6 6 6 6 6 6 6 6 6 6 6 6 6
6 6 6 6 6 6 6 6 6 6 6 6 6 6 6 6 6 6 6 6 6 6 6 6 6 6 6 6 6 6 6 6 6 6 6 6 6 6 6 6 6 6 6 6 6 6 6 6 6 6 6 6 6 6 6
6 6 6 6 6 6 6 6 6 6 6 6 6 6 6 6 6 6 6 6 6 6 6 6 6 6 6 6 6 6 6 6 6 6 6 6 6 6 6 6 6 6 6 6 6 6 6 6 6 6 6 6 6 6 6
6 6 6 6 6 6 6 6 6 6 6 6 6 6 6 6 6 6 6 6 6 6 6 6 6 6 6 6 6 6 6 6 6 6 6 6 6 6 6 6 6 6 6 6 6 6 6 6 6 6 6 6 6 6 6
6 6 6 6 6 6 6 6 6 6 6 6 6 6 6 6 6 6 6 6 6 6 6 6 6 6 6 6 6 6 6 6 6 6 6 6 6 6 6 6 6 6 6 6 6 6 6 6 6 6 6 6 6 6 6
6 6 6 6 6 6 6 6 6 6 6 6 6 6 6 6 6 6 6 6 6 6 6 6 6 6 6 6 6 6 6 6 6 6 6 6 6 6 6 6 6 6 6 6 6 6 6 6 6 6 6 6 6 6 6
6 6 6 6 6 6 6 6 6 6 6 6 6 6 6 6 6 6 6 6 6 6 6 6 6 6 6 6 6 6 6 6 6 6 6 6 6 6 6 6 6 6 6 6 6 6 6 6 6 6 6 6 6 6 6
6 6 6 6 6 6 6 6 6 6 6 6 6 6 6 6 6 6 6 6 6 6 6 6 6 6 6 6 6 6 6 6 6 6 6 6 6 6 6 6 6 6 6 6 6 6 6 6 6 6 6 6 6 6 6
6 6 6 6 6 6 6 6 6 6 6 6 6 6 6 6 6 6 6 6 6 6 6 6 6 6 6 6 6 6 6 6 6 6 6 6 6 6 6 6 6 6 6 6 6 6 6 6 6 6 6 6 6 6 6
6 6 6 6 6 6 6 6 6 6 6 6 6 6 6 6 6 6 6 6 6 6 6 6 6 6 6 6 6 6 6 6 6 6 6 6 6 6 6 6 6 6 6 6 6 6 6 6 6 6 6 6 6 6 6
6 6 6 6 6 6 6 6 6 6 6 6 6 6 6 6 6 6 6 6 6 6 6 6 6 6 6 6 6 6 6 6 6 6 6 6 6 6 6 6 6 6 6 6 6 6 6 6 6 6 6 6 6 6 6
6 6 6 6 6 6 6 6 6 6 6 6 6 6 6 6 6 6 6 6 6 6 6 6 6 6 6 6 6 6 6 6 6 6 6 6 6 6 6 6 6 6 6 6 6 6 6 6 6 6 6 6 6 6 6
6 6 6 6 6 6 6 6 6 6 6 6 6 6 6 6 6 6 6 6 6 6 6 6 6 6 6 6 6 6 6 6 6 6 6 6 6 6 6 6 6 6 6 6 6 6 6 6 6 6 6 6 6 6 6
6 6 6 6 6 6 6 6 6 6 6 6 6 6 6 6 6 6 6 6 6 6 6 6 6 6 6 6 6 6 6 6 6 6 6 6 6 6 6 6 6 6 6 6 6 6 6 6 6 6 6 6 6 6 6
6 6 6 6 6 6 6 6 6 6 6 6 6 6 6 6 6 6 6 6 6 6 6 6 6 6 6 6 6 6 6 6 6 6 6 6 6 6 6 6 6 6 6 6 6 6 6 6 6 6 6 6 6 6 6
6 6 6 6 6 6 6 6 6 6 6 6 6 6 6 6 6 6 6 6 6 6 6 6 6 6 6 6 6 6 6 6 6 6 6 6 6 6 6 6 6 6 6 6 6 6 6 6 6 6 6 6 6 6 6
6 6 6 6 6 6 6 6 6 6 6 6 6 6 6 6 6 6 6 6 6 6 6 6 6 6 6 6 6 6 6 6 6 6 6 6 6 6 6 6 6 6 6 6 6 6 6 6 6 6 6 6 6 6 6
6 6 6 6 6 6 6 6 6 6 6 6 6 6 6 6 6 6 6 6 6 6 6 6 6 6 6 6 6 6 6 6 6 6 6 6 6 6 6 6 6 6 6 6 6 6 6 6 6 6 6 6 6 6 6
6 6 6 6 6 6 6 6 6 6 6 6 6 6 6 6 6 6 6 6 6 6 6 6 6 6 6 6 6 6 6 6 6 6 6 6 6 6 6 6 6 6 6 6 6 6 6 6 6 6 6 6 6 6 6
6 6 6 6 6 6 6 6 6 6 6 6 6 6 6 6 6 6 6 6 6 6 6 6 6 6 6 6 6 6 6 6 6 6 6 6 6 6 6 6 6 6 6 6 6 6 6 6 6 6 6 6 6 6 6
6 6 6 6 6 6 6 6 6 6 6 6 6 6 6 6 6 6 6 6 6 6 6 6 6 6 6 6 6 6 6 6 6 6 6 6 6 6 6 6 6 6 6 6 6 6 6 6 6 6 6 6 6 6 6
6 6 6 6 6 6 6 6 6 6 6 6 6 6 6 6 6 6 6 6 6 6 6 6 6 6 6 6 6 6 6 6 6 6 6 6 6 6 6 6 6 6 6 6 6 6 6 6 6 6 6 6 6 6 6
6 6 6 6 6 6 6 6 6 6 6 6 6 6 6 6 6 6 6 6 6 6 6 6 6 6 6 6 6 6 6 6 6 6 6 6 6 6 6 6 6 6 6 6 6 6 6 6 6 6 6 6 6 6 6
6 6 6 6 6 6 6 6 6 6 6 6 6 6 6 6 6 6 6 6 6 6 6 6 6 6 6 6 6 6 6 6 6 6 6 6 6 6 6 6 6 6 6 6 6 6 6 6 6 6 6 6 6 6 6
6 6 6 6 6 6 6 6 6 6 6 6 6 6 6 6 6 6 6 6 6 6 6 6 6 6 6 6 6 6 6 6 6 6 6 6 6 6 6 6 6 6 6 6 6 6 6 6 6 6 6 6 6 6 6
